XXXXXXXXXXXXXXX
XXXX XXXXX XX X
X HH HH  XX   X
X XX HH     HHX
X         X HHX
X       HHXXH X
X       HHX XHX
X    HH  HX XXX
XXH  HH HH XX X
XXH     XX XX X
XX      XX    X
XX            X
XX HH  HH XX  X
X  HH  HH  X  X
XXXXXXXXXXXXXXX
