XXXXXXXXXXXXXXX
XXXX  HHXXXXHHX
XX XX      XXHX
XX XX         X
XX            X
X X    H      X
XHXXXHHHH HHXXX
XHHXX HH   HXXX
XXHX          X
XXX           X
X XX  HH      X
XXXXXXHH      X
XX  XX  XX    X
X       XX    X
XXXXXXXXXXXXXXX
