XXXXXXXXXXXXXXX
XXHX XXXXX XX X
X HH HH  XX   X
X XX HH     HHX
X         XXHHX
X       HHXXHHX
X       HXX XHX
X    HH  XX XXX
XHH  HH HH XX X
XXH     XX XX X
XX      XX    X
XX            X
XX HH  HH XX  X
X  HH  HH  X  X
XXXXXXXXXXXXXXX
