XXXXXXXXXXXXXXX
XXXX  HHXXXXXHX
XX XX      XHHX
XX XX         X
XX            X
X XX   HH     X
XHHXXHHHH HHXXX
XHHXX HH   HXXX
XXHX          X
XXX           X
X XX  HH      X
XXXXXXHH      X
XX  XX  XX    X
X       XX    X
XXXXXXXXXXXXXXX
