XXXXXXXXXXXXXXX
XXXX  HHXXXXHHX
XX XX      XXHX
XX XX         X
XX            X
X X    H      X
XHHXXHHHH HHXXX
XHHXX HH   HXXX
XXXX          X
XXX           X
X XX  HH      X
XXXXXXHH      X
XX  XX  XX    X
X       XX    X
XXXXXXXXXXXXXXX
