XXXXXXXXXXXXXXX
XXXXXXXXXXXXX X
X HX HH  XX   X
X XX HH     HHX
X         XXHHX
X       HHXXHHX
X       HXX HXX
X    HH HXX XXX
XHH  HH HH XX X
XXH     XX XX X
XX      XX    X
XX            X
XX HH  HH XX  X
X  HH  HH  X  X
XXXXXXXXXXXXXXX
